width: 10
height: 10
person: 5 5

##########
##_______#
#________#
#____##__#
#________#
#________#
#__###___#
#________#
#________#
##########